15
###############
#/            #
#*#*#*#*#*#*# #
#             #
#!#*#b#*#*#*#*#
#            !#
#*#*#*#*#*#s# #
#             #
#!#*#*#*#*#*#*#
#             #
#*#*#*#*#*#*# #
#            !#
# #=#*#*#*#*#*#
#!            #
###############