15
###############
#    !*   * * #
# # #*# #*#f# #
#  ** **     !#
# # # # # # # #
#* / *  ! *   #
# # # # # #b# #
# *  *   *  * #
# # # # # # # #
# * *    *  * #
# # #s# #=# # #
#*      *  *  #
# #*# # # # # #
#%  *         #
###############