15
###############
# *  !      *s#
# # # #=# # # #
#*  *  **    !#
# # # # #*# # #
#  /    *  *  #
# # # # # # # #
#*   * *      #
# # #b# # # #*#
#  % *   *    #
# # #*# # # # #
#   *    *    #
# # # #f# # #*#
#* !*        %#
###############